111111111111111
1CECCCCCCCCCCC1
11111111C1111C1
1CCCCCCCC1CCCC1
1C111111C1111C1
1CCCCCCCCCCCCC1
11111C1111C1111
1CCCCCCCC1CCCC1
1111111C1111111
1CCPCCCCCCCCCC1
111111111111111
