111111111111111
1CECCCCCC00N001
11111111C1111C1
1000000001CCCC1
1C111111C1111C1
1CCCN000CCCCCC1
11011C1111C1101
1C00000CC100001
1110111C1111011
1CCPCCCCC000001
111111111111111
