111111111111111
100000000000001
11110000000E001
101000000000001
11110000C000001
100000010000001
100000111111111
100000000100001
111111110000001
100100000000001
111110000001111
1000000P0000101
111111111111111
