11111111111111
100C0000C00C01
11111110111111
10C00C00C00C01
10111111111011
10000000000001
11111011011111
10C0001100C001
11001111111111
10CECP0000C001
11111111111111
