1111111111
10E00P0C01
1111111111